%%%%%%%%%
%....   %
%.%% %%.%
%.%%.%%.%
%.%%%%%.%
%P%.....%
%%%%%%%%%
