%%%%%%%%%
%.......%
%.%% %%.%
%.%%.%%.%
%.%%%%%.%
%P%.....%
%%%%%%%%%
